F 100,100,100
C 200,200,200

NO ./textures/wall_no.png
SO ./textures/wall_so.png
WE ./textures/wall.png
EA ./textures/wall_ea.png

             1111111111
             1001000101
 1111111111111011010001
100000000000000011 111
10000111011111111
1110100001
1000101101
1010000001
10111S1101
1000000001
1111111111