F 100,100,100
C 200,200,200

NO ./textures/wall_no.png
SO ./textures/wall_so.png
WE ./textures/wall_we.png
EA ./textures/wall_ea.png

        1111111111111111111111111
        1000000000110000000000001
        1011000001110000N00000001
        1001000000D00000000000001
111111111011000001110000000000001
100000000011000001110111111111111
11110111111111011100000000001
11110111111111011101010010001
11000000110101011100000010001
10000000000000001100000010001
10000000000000000001010010001
1100000111010101111101111000111
11110111 1110101 111000000111
11111111 1111111 111111111111

