F 1,255,0
C 220,30,0

NO ./textures/north_txtr.png
SO ./textures/south_txtr.png
WE ./textures/west_txtr.png
EA ./textures/east_txtr.png

        1111111111111111111111111
        1000000000110000000000001
        10110E0001110000000000001
        1001000000000000000000001
111111111011000001110000000000001
100000000011000001110111111111111
11110111111111011100000010001
11110111111111011101010010001
11000000110101011100000010001  
10000000000000001100000010001 
10000000000000000001010010001
1100000111010101111101111000111
11110111 1110101 111000111111
11111111 1111111 111111111111

